#######
#     #
 ## ## 
#     #
####### 