###########
#         #
# ####### #
#       # #
# ##### # #
# #   # # #
# # # # # #
#   #     #
########### 