########
#      #
 ######
#      #
######## 